                                                                                                                                                                                                        
  5555555555555555555555555555555555555555555555555555555555555555555555555555555555555555555555555555555555555555555555555555555555555555555555555555555555555555555555555555555555555555555555555555  
 555555555555555555555555555555555555555555555555555555555555555555555555555555555555555555555555555555555555555555555555555555555555555555555555555555555555555555555555555555555555555555555555555555 
 55        55                  55                           55                                          55                                     55                                55        55        55 
 55        55                  55                           55                                          55                                     55                                55        55        55 
 55        55                  55                           55                                          55                                     55                                55        55        55 
 5555555   5555555   5    5    555555    555555    555555   555555    5    55555555555555555555555555   55555555555    5    5    5555555555555555   555555555555555555555    5   55   55   555555    55 
 5555555   5555555   55   55   5555555  5555555   5555555   5555555   55   55555555555555555555555555   555555555555  555  55   55555555555555555   555555555555555555555   55   55   55   5555555   55 
 55   55        55   55   55       555  55        55   55        55   55                 55             55        55  555  55   55             55             55       55   55        55   55        55 
 55   55        55   55   55       555  55        55   55        55   55                 55             55        55  555  55   55             55             55       55   55        55   55        55 
 55   55        55   55   55       555  55        55   55        55   55                 55             55        55  555  55   55             55             55       55   55        55   55        55 
 55   5555555   55   55   555555   5555555    555555   5555555   55   5555555555555555   555555555555   55   5    5555555  5555555    555555   55555555555    555555   55   555555555555   55   5    55 
 55   5555555   55   55   5555555  5555555   5555555   5555555   55   5555555555555555   555555555555   55   55   5555555  5555555   5555555   555555555555   555555   55   555555555555   55   55   55 
 55        55   55   55   55   55            55             55   55   55            55             55   55   55       555                 55                           55   55                  55   55 
 55        55   55   55   55   55            55             55   55   55            55             55   55   55       555                 55                           55   55                  55   55 
 55        55   55   55   55   55            55             55   55   55            55             55   55   55       555                 55                           55   55                  55   55 
 55   55   55   5555555   55   5555555555555555   5555555   55   55   55   555555   5555555   55   55   55   5555555  555   555555555555555555555555555555555555555555555   55   55555555555555555   55 
 55   55   55   5555555   55   5555555555555555   5555555   55   55   55   5555555  5555555   55   55   55   5555555  555  5555555555555555555555555555555555555555555555   55   55555555555555555   55 
 55   55   55   55        55       555            55        55   55   55       555       55   55   55        55   55  555            55        55        55                 55   55        55        55 
 55   55   55   55        55       555            55        55   55   55       555       55   55   55        55   55  555            55        55        55                 55   55        55        55 
 55   55   55   55        55       555            55        55   55   55       555       55   55   55        55   55  555            55        55        55                 55   55        55        55 
 55   55   55   55   5555555   55  555  5555555   5555555   55   55   5555555  5555555   55   55   555555555555   55  55555555555555555   55   55   55   55   55555555555   5555555   55   55   5555555 
 55   55   55   55   5555555   55  555   555555    555555   55   55   5555555   555555   55   55   55555555555    55   5555555555555555   55   55   55   5    55555555555   5555555   55   55   5555555 
 55   55   55        55   55   55  555       55        55   55   55        55       55   55   55        55        55            55        55        55        55            55        55   55        55 
 55   55   55        55   55   55  555       55        55   55   55        55       55   55   55        55        55            55        55        55        55            55        55   55        55 
 55   55   55        55   55   55  555       55        55   55   55        55       55   55   55        55        55            55        55        55        55            55        55   55        55 
 55   55555555555555555   55   55  5555555   5555555   55   55   5555555   5555555  55   55   5555555   55   5555555555555555   55   55555555555555555555555555555555555555555   5555555   5555555   55 
 55   55555555555555555   5    55   555555    555555   55   55   5555555   5555555  55   55   5555555   55   5555555555555555   55    5555555555555555555555555555555555555555    555555   5555555   55 
 55   55             55        55       55   55   55   55   55        55       555  55   55   55        55   55            55   55                                                    55   55   55   55 
 55   55             55        55       55   PP5  55   55   55        55       555  55   55   55        55   55            55   55                                                    55   55   55   55 
 55   55             55        55       55   55   55   55   55        55       555  55   55   55        55   55            55   55                                                    55   55   55   55 
 55   55   55   5555555   555555555555  55   5555555   555555555555   555555555555  55   55   55   5555555   55   55  5555555   55   55555555555555555   5555555555555555555555555555555   55   55   55 
 55    5   55   5555555   55555555555   55   5555555   555555555555   555555555555  55   55   55   555555    55   55  5555555   55    5555555555555555   5555555555555555555555555555555   55   5    55 
 55        55        55        55       55   55        55        55   55       555  55   55   55   55        55   55  555       55        55        55            555       55             55        55 
 55        55        55        55       55   55        55        55   55       555  55   55   55   55        55   55  555       55        55        55            555       55             55        55 
 55    5   55   5    55        55   5   55   55        55        55   55       555  55   55   55   55        55   55  555   5   55    5   55        55   5    5   555   5   55    5    5   55   5    55 
 55   555555555555   5555555   55  5555555   55   5555555   55   55   55   55  555  55   5555555   55   55   55   55  555  5555555   5555555   55   555555555555  555  5555555   555555555555   5555555 
 55   555555555555   555555    55  5555555   55    555555   55   55   5    55   5   55    555555   55   55   55   55  555  5555555   5555555   55   555555555555   5   5555555   55555555555    5555555 
 55   55        55             55  555       55             55   55        55       55             55   55   55   55  555  55        55        55   55        55       55        55             55   55 
 55   55        55             55  555       55             55   55        55       55             55   55   55   55  555  55        55        55   55        55       55        55             55   55 
 5555555    5   555555    5555555  555   555555555555555555555   555555555555555555555555555555555555   55   55   55  555  55    555555    555555   55   5    555555   55    55555555555   5555555   55 
 5555555   55   5555555   5555555  555  5555555555555555555555   555555555555555555555555555555555555   55   55   55  555  55   5555555   5555555   55   55   5555555  55   555555555555   5555555   55 
 5555555   55    555555    555555   5    55555555555555555555    555555555555555555555555555555555555   55        55   5   55    555555    555555   55   55   5555555  55    55555555555   555555    55 
 55        55        55        55                 55   55             55   55                      55   55        55       55        55        55   55   55       555  55             55   55        55 
 55        55        55        55                 55   55             55   55                      55   55        55       55        55        55   55   55       555  55             55   55        55 
 55    55555555555   55555555555555555555555555   55   55   555555    55   55   5    5555555555555555   55555555555555555555555555   5555555   55   55   555555   555555555555    5   55   555555    55 
 55   555555555555   55555555555555555555555555   55   55   5555555   55   55  555  55555555555555555   55555555555555555555555555   5555555   55   55   5555555  555555555555   55   55   5555555   55 
 55        55   55                 555                 55   55             55  555  55             55             55       55             55   55   55        55            55   55   55             55 
 55        55   55                 555                 55   55             55  555  55             55             55       55             55   55   55        55            55   55   55             55 
 55        55   55                 555                 55   55             55  555  55             55             55       55             55   55   55        55            55   55   55             55 
 55    5   55   5555555555555555   55555555555555555   55   55   555555555555  555  55    555555   55555555555    55   5   555555555555   55   55   555555    55555555555   5555555   55555555555    55 
 55   55   55   55555555555555555  55555555555555555   55   55   555555555555  555  55   5555555   555555555555   55  555  555555555555   55   55   5555555   55555555555   5555555   555555555555   55 
 55   55   55                  55                 55   55   55        55       555       55                  55       555            55   55   55             55                      55             55 
 55   55   55                  55                 55   55   55        55       555       55                  55       555            55   55   55             55                      55             55 
 55   55   55                  55                 55   55   55        55       555       55                  55       555            55   55   55             55                      55             55 
 55   55   5555555   55555555555555555555555555   5555555   555555    55   5555555555555555    5555555555    555555555555555555555   5555555   55555555555555555555555555555555555555555555555555    55 
 55   55   5555555   55555555555555555555555555   5555555   5555555   55   5555555555555555   555555555555   555555555555555555555   5555555   555555555555555555555555555555555555555555555555555   55 
 55   55   55        55        55            55        55        55   55       555            55        55                      55   55        55                           55                  55   55 
 55   55   55        55        55            55        55        55   55       555            55        55                      55   55        55                           55                  55   55 
 55   55   55        55        55            55        55        55   55       555            55        55                      55   55        55                           55                  55   55 
 55   55   55   5555555   55   55   5   555555555555   55   55   555555555555  555  555555555555   55   5555555   55555555555   55   55   5555555   555555555555555555555   55   555555555555   55   55 
 55   55   55   5555555   55   55  555  555555555555   55   55   555555555555  555  555555555555   55   5555555   55555555555   55   55   5555555   555555555555555555555   55   555555555555   55   55 
 55   55   55             55       555            55   55   55                 555  55        55   55        55   55       55   55   55        55   55            555       55        55        55   55 
 55   55   55             55       555            55   55   55                 555  55        55   55        55   55       55   55   55        55   55            555       55        55        55   55 
 55   55   55             55       555            55   55   55                 555  55        55   55        55   55       55   55   55        55   55            555       55        55        55   55 
 55   55   55   55555555555555555555555555   5555555   555555555555   555555555555  55   55   55   555555555555   55   55  5555555   55   55   55   555555555555  555  55   5555555   55   5555555   55 
 55   55   55   55555555555555555555555555    555555   555555555555   55555555555   55   55    5   55555555555    55  555  5555555   55   55   55   55555555555   555  55    555555   55   555555    55 
 55   55   55        55                 55             55        55   55            55   55        55             55  555  55        55   55   55                 555  55        55   55   55        55 
 55   55   55        55                 55             55        55   55            55   55        55             55  555  55        55   55   55                 555  55        55   55   55        55 
 55   55   55        55                 55             55        55   55            55   55        55             55  555  55        55   55   55                 555  55        55   55   55        55 
 55   55   5555555   55   5555555555555555   555555555555   55   5555555   55555555555   555555555555   555555555555  555  55   5555555   55   555555555555   5555555  555555555555   55   55   5555555 
 55   55   5555555   5    5555555555555555   555555555555   55   5555555   55555555555    55555555555   55555555555   555   5   5555555   55   555555555555   555555   555555555555   55   55   5555555 
 55   55   55             55            55   55             55        55   55       55                  55            555       55        55             55   55       55        55   55   55        55 
 55   55   55             55            55   55             55        55   55       55                  55            555       55        55             55   55       55        55   55   55        55 
 55   55   55             55            55   55             55        55   55       55                  55            555       55        55             55   55       55        55   55   55        55 
 55   55   55555555555555555   5555555  55   5555555   555555555555   55   55  555  55   55555555555555555   5555555555555555555555555555555   555555555555   55  555  55   55   55   55   5555555   55 
 55   55   5555555555555555    5555555  55    555555    55555555555   5    55  555  55   55555555555555555   5555555555555555555555555555555   55555555555    55  555  55   55    5   55   5555555   55 
 55   55   55                  55  555  55        55             55        55  555  55   55             55            555                 55                  55  555  55   55        55        55   55 
 55   55   55                  55  555  55        55             55        55  555  55   55             55            555                 55                  55  555  55   55        55        55   55 
 55   55   55    5555555555555555  555  5555555   55555555555    555555555555  555  55   55    55555    55555555555   5555555    55555    55    5555555555555555  5555555   5555555555555555    55   55 
 55   55   55   55555555555555555  555  5555555   555555555555   555555555555  555  55   55   5555555   555555555555  5555555   5555555   55   55555555555555555  5555555   55555555555555555   55   55 
 55   55    5   5555555555555555   555  5555555    5555555555    55555555555   555  55   55   5555555   555555555555   555555   5555555   55   55555555555555555   555555   5555555555555555    55   55 
 55   55        55                 555  55                       55            555  55   55   55   55             55            55        55   55             55            55                  55   55 
 55   55        55                 555  55                       55            555  55   55   55   55             55            55        55   55             55            55                  55   55 
 55   555555555555   555555    5555555  555555555555555555555555555   555555555555  5555555   55   555555    555555555555555555555    555555   55   555555    5555555555555555    5555555555555555   55 
 55   555555555555   5555555   5555555  555555555555555555555555555   555555555555  5555555   55   5555555   555555555555555555555   5555555   55   5555555   5555555555555555   55555555555555555   55 
 55    5    5   55   55        55   5   55    5    5    5   5    5         55   5   55    5   55    5   55        5    5    5   55   55        55   55   55   5   555   5   55        55   5    5    55 
 55             55   55        55       55                                 55       55        55        55                      55   55        55   55   55       555       55        55             55 
 55             55   55        55       55                                 55       55        55        55                      55   55        55   55   55       555       55        55             55 
 555555555555   55   55   5555555   5   55    5555555555555555555555555555555   5   55    55555555555   555555    55555555555   55   55    555555   55   55   5   5555555   5555555   55555555555555555 
 555555555555   55   55   5555555  555  55   55555555555555555555555555555555  555  55   555555555555   5555555   55555555555   55   55   5555555   55   55   55  5555555   5555555   55555555555555555 
 55             55   55        55  555  55   55                       55       555  55             55        55            55   55   55   55             55   55       55        55        55        55 
 55             55   55        55  555  55   55                       55       555  55             55        55            55   55   55   55             55   55       55        55        55        55 
 55             55   55        55  555  55   55                       55       555  55             55        55            55   55   55   55             55   55       55        55        55        55 
 55    55555555555555555555    55  5555555   555555555555   555555555555   5555555  555555555555   555555    55555555555   5555555   55   55555555555555555   555555   55    5   5555555   55   5    55 
 55   5555555555555555555555   55  5555555   555555555555   555555555555   5555555  555555555555   5555555   555555555555  5555555   55   55555555555555555   5555555  55   55   5555555   55   55   55 
 55        55             55   55            55             55        55   55  555            55                      555       55   55                       55            55        55        55   55 
 55        55             55   55            55             55        55   55  555            55                      555       55   55                       55            55        55        55   55 
 55        55             55   55            55             55        55   55  555            55                      555       55   55                       55            55        55        55   55 
 5555555   55   555555    55   5555555555555555    555555   55   5    55   55  555555555555   555555555555555555555   5555555   55   5555555   555555555555555555555555555555555555555555555555555   55 
 5555555   55   5555555   55   5555555555555555   5555555   55   55   55   55  555555555555   5555555555555555555555  5555555   55   5555555   555555555555555555555555555555555555555555555555555   55 
 55   55   55        55                 55        55   55   55   55        55            55             55        55  555       55        55   55                 555                           55   55 
 55   55   55        55                 55        55   55   55   55        55            55             55        55  555       55        55   55                 555                           55   55 
 55   55   55        55                 55        55   55   55   55        55            55             55        55  555       55        55   55                 555                           55   55 
 55   55   55   55   55555555555555555  55   5555555   55   55   555555555555555555555   55   555555555555   55   55  555  555555555555   5555555   555555555555  555  5555555555555555555555   55   55 
 55   55   55   55   55555555555555555  55   5555555   55   55   555555555555555555555   55   555555555555   55   55  555   55555555555   5555555   555555555555  555  5555555555555555555555   55   55 
 55   55   55   55   55            555       55             55   55                 55   55   55             55   55  555       55        55        55            555       55        55        55   55 
 55   55   55   55   55            555       55             55   55                 55   55   55             55   55  555       55        55        55            555       55        55        55   55 
 55   55   55   55   55            555       55             55   55                 55   55   55             55   55  555       55        55        55            555       55        55        55   55 
 55   55   5555555   55   55   5555555555555555   555555555555   55   55555555555   55   55   55   555555555555   55  5555555   55   5555555   5555555   555555555555  55   5555555   55   5555555   55 
 55   55    555555   55   55   5555555555555555   555555555555   55   55555555555   55    5   55   555555555555   5   5555555   55   5555555   555555    55555555555   55    555555   55   555555    55 
 55   55             55   55   55       55        55   55        55   55   55       55        55   55        55       555  55   55   55        55        55            55        55        55        55 
 55   55             55   55   55       55        55   55        55   55   55       55        55   55        55       555  55   55   55        55        55            55        55        55        55 
 55   55             55   55   55       55        55   55        55   55   55       55        55   55        55       555  55   55   55        55        55            55        55        55        55 
 55   55555555555555555   55   55  555  55   5555555   55   5555555   55   55  55555555555555555   5555555   555555555555  55   55   55   5555555   55555555555555555555555555   55   5555555   55   55 
 55    555555555555555    55   5   555   5    555555   55   555555    5    55   5555555555555555   555555    55555555555   55    5    5   5555555   55555555555555555555555555   55   555555    55   55 
 55                       55       555                 55                  55                                              55             55                                     55             55   55 
 55                       55       555                 55                  55                                              55             55                                     55             55   55 
 55                       55       555                 55                  55                                              55             55                                     55             55   55 
 555555555555555555555555555555555555555555555555555555555555555555555555555555555555555555555555555555555555555555555555555555555555555555555555555555555555555555555555555555555555555555555555555555 
  5555555555555555555555555555555555555555555555555555555555555555555555555555555555555555555555555555555555555555555555555555555555555555555555555555555555555555555555555555555555555555555555555555  
                                                                                                                                                                                                        
